CCR4	TTCATGTGTTTGTGC
CCR5	ACCAGTTGTCATTAC
CCR6	CTCTCTGCATTCCTC
CCR7	TTATTAACAGCCCAC
CCR8	ATCTCCGTTGTGCGA
CCR9	CCCTCTGGTATGGTT
CXCR2	TTTCCTTGTAGAGCG
CXCR3	GTTCACGCCGTGTTA
CXCR4	GTCGTGGTGTTGTTC
CXCR5	ACGTAGTCACCTAGT
CXCR6	TGTCAGGTTGTATTC
CX3CR1	CACTCTCAGTCCTAT
XCR1	TCCATTACCCACGTT
Streptavidin 	TGCCAGCCCTTTGTA
HTO1	ACCCACCAGTAAGAC
HTO2	GGTCGAGAGCATTCA
HTO3	CTTGCCGCATGTCAT
Mouse_IgG2a CTCCTACCTAAACTG
Armenian_Hamster_IgG	CCTGTCATTAAGACT
Rat_IgG2b GATTCTTGACGACCT
